                                                               &                     
                                                            *&  &    * *             
                                                                 &    &              
                                                                 &*                  
                                                                 &                   
                                                                  *    &             
                                                                 &* & &&             
                %    #%   ##                                    &                    
               # # #   ###                                         &  *              
                       & # %                   &        * &           &              
                      &    #                       *&  &  && &                       
           * &       &  * #                                * &           *           
         & *&      & * & # #               *       &         *        &*  &          
         &                            &    &    *&        &                &         
               *&       ##                     &          *    &                     
              & *         #%     % **      &      *            & &                   
                &          #%#   ## &       *    & &*       *& *         &           
                *                 #              *       & &   &                     
          &                    %  %#                          *             *        
         &*      &            # # %#%    &                *               &&         
        & *   &      &      %#%#  #            &          &         *     *&*        
      &              *&*           %  *      &&           &    &*    &               
           *       *  *      #    ## & & &*       *            *    * *  &*          
            &      &         #  #          &   *   &*           &         &          
                     *       #        &   * *& &  &*                    *            
          * * &     &         ## ##  *      *  **&               *    &&             
          &&*&     &                             *               & * *  &            
           *  *   &                                               *& &               
                                                                                     
            *   &                               *&                                   
           &     *  &                       &                                        
            *   *&                          &  *    &                                
       &          *                           *& & &*                                
                                               *&                                    
                                                *      &                             
                    %  #  # #                          *                             
                     #%#  # %                          &                             
                     %  ###                      &   &&*                             
                     #  ##% #               &   *  & *                               
                    %%   % %                          *                              
                     #    # #               &         &                              
                     #   #                 %     *    &                              
                       #  #               #     &                                    
                                            %    &                                   
                                           #  #  #                                   
                                            # #  # #                                 
                                          ##   %#                                    
                                  #       %#    #                                    
                                 # # # #  %     %                                    
                                 ## %#  %##                                          
                                   ##%% ## %                                         
                                    ###  % #     %                                   
                                 ## % #%       ##                                    
                   %              #% #%%   #  %                                      
                  #  ##    #          %     % #                                      
                      #        ##    # #  # ##  #                                    
                  # #   #    #       ## ### ## %#                                    
                                    % %  %#   #                                      
                           ##    ###      #   #                                      
                   ##  #%  #%%### %       %                                          
                    %#  #### ### #                                                   
                    % ##%# #   #                                                     
                    #        #  #                                                    
  #    ###           ##   # # #%%                                                    
       #%             #       ##                                                     
   # ## %           ##  # #                                                          
    #%##                                                                             
     # #                                                                             
  #  ##                                                                              
 %#   %  #                                                                           
  #   #                                                                              
                                                                                     
                                                                                     
                                                                                     
                                                                                     
                                                                                     
                               ## ##                                                 
                                #  #                                                 
                                #                                                    
                                 #% %                                                
                                # %##                                                
                                #  ##                                                
                             % # %#                                                  
                             #%# ##%                                                 
                                                                                     
